NO ./img/
SO ./img/
WE ./img/

EA ./img/
F 0,128,0

C 0,0,255

        1111111111111111111111111
        1000000000110000000000001
        1011000001110111111111111
        10010000000001000111110001
111111111011000001110000000000001
100000000011000001110111111111111
11100111110011011000000010001
1110011000010001101010010001
11110000110101001100100001001
10000E00110001110011000100101
1001011000001  100000011000011
1101100111010111111101111011
1100001 1100001 101100000001
1111111 1111111 111111111111
