NO ./img/
SO ./img/
WE ./img/

EA ./img/
F 0,128,0

C 0,0,255

111111111111111111111111
100000000010000000000001
101100000111011111111111
1001000N0000010001110001
111111111011000100000001
111111111111111111111111
